{"ids":[
4,2,5,2,
1,4,1,3,
1,4,3,2,
3,5,4,2,
1,3,5,5,
0,0,0,0,
0,0,0,0]}