{"ids":[
1,4,5,4,
3,3,5,8,
2,3,1,5,
6,2,6,2,
8,1,6,4,
4,5,1,6,
2,8,8,3,
0,0,0,0,0,0,0,0]}