{"ids":[
1,2,1,5,
2,7,3,3,
4,4,4,3,
7,6,5,5,
5,4,1,2,
3,1,6,7,
2,6,7,6,
0,0,0,0,0,0,0,0]}