{"ids":[
1,6,2,5,
5,3,4,4,
5,6,6,2,
1,9,2,9,
1,6,1,3,
4,9,2,9,
3,3,5,4,
0,0,0,0,0,0,0,0]}