{"ids":[
8,4,2,2,
6,1,1,4,
8,8,4,2,
1,6,6,8,
2,1,4,6,
0,0,0,0,0,0,0,0]}