{"ids":[
2,3,3,4,
4,4,1,1,
3,1,5,1,
5,2,2,2,
5,5,4,3,
0,0,0,0,
0,0,0,0]}