{"ids":[
6,4,2,6,
1,4,7,7,
6,6,7,4,
1,2,2,7,
1,1,2,4,
0,0,0,0,
0,0,0,0]}