{"ids":[
2,5,2,4,
1,5,7,2,
7,5,5,1,
1,2,1,4,
7,7,4,4,
0,0,0,0,
0,0,0,0,0,0,0,0]}