{"ids":[
1,2,2,5,
4,4,5,7,
1,2,7,7,
5,1,1,5,
2,7,4,4,
0,0,0,0,0,0,0,0]}